0,0,0,0,0,0,0,0,0,0,0,1,0,0,0,0,0
1,0,0,0,1,0,0,0,0,0,0,0,0,0,0,0,0
2,0,0,0,1,0,0,0,0,0,0,0,0,0,0,0,0
3,0,0,1,0,0,0,0,0,0,0,0,0,0,0,0,0
4,0,0,0,0,0,0,0,0,0,0,0,0,0,0,0,1
5,0,0,0,0,0,0,0,0,0,0,0,1,0,0,0,0
6,0,0,0,0,1,0,0,0,0,0,0,0,0,0,0,0
7,0,0,0,0,0,0,0,0,0,0,0,0,1,0,0,0
8,0,0,0,0,0,0,0,0,0,0,0,0,0,0,0,1
9,0,0,0,0,0,1,0,0,0,0,0,0,0,0,0,0
10,0,0,0,0,0,0,0,0,0,1,0,1,0,0,0,0
11,0,0,0,0,0,1,0,0,0,0,0,0,0,0,0,0
12,0,0,0,0,0,0,0,0,0,0,0,1,0,0,0,0
13,0,0,0,0,0,0,0,0,0,0,0,1,0,0,0,0
14,0,0,0,0,0,1,0,0,0,0,0,0,0,0,0,0
15,0,0,0,0,1,0,0,0,0,0,0,0,0,0,0,0
16,0,0,0,0,1,0,0,0,0,0,0,0,0,0,0,0
17,0,0,0,0,1,0,0,0,0,0,0,0,0,0,0,0
18,0,0,0,0,0,0,0,0,0,0,0,1,0,0,0,0
19,0,0,0,0,0,1,0,0,0,0,0,0,0,0,0,0
20,0,0,0,0,0,1,0,0,0,0,0,0,0,0,0,0
21,0,0,0,0,0,1,0,0,0,0,0,0,0,0,0,0
22,0,0,0,0,0,1,0,0,0,0,0,0,0,0,0,0
23,0,1,0,0,0,0,0,0,0,0,0,0,0,0,0,0
24,0,0,0,0,0,0,0,0,0,0,0,0,1,0,0,0
25,0,1,0,0,0,0,0,0,0,0,0,0,0,0,0,0
26,0,0,1,0,0,0,0,0,0,0,0,0,0,0,0,0
27,0,0,0,0,0,1,0,0,0,0,0,0,0,0,0,0
28,0,1,0,0,0,0,0,0,0,0,0,0,0,0,0,0
29,1,0,0,0,0,0,0,0,0,0,0,0,0,0,0,0
30,0,0,0,0,0,0,0,1,0,0,0,0,0,0,0,0
31,1,0,0,0,0,0,0,0,0,0,0,0,0,0,0,0
32,0,0,0,0,0,0,0,0,0,0,0,0,0,0,1,1
33,0,0,0,0,0,0,0,0,0,0,0,0,0,0,1,1
34,0,0,0,0,1,0,0,0,0,0,0,0,0,0,0,0
35,0,0,0,0,1,0,0,0,0,0,0,0,0,0,0,0
36,0,0,0,0,0,0,0,0,1,0,0,0,0,0,0,0
37,1,1,0,0,0,0,0,0,0,0,0,0,0,0,0,0
38,1,0,0,0,0,0,0,0,0,0,0,0,0,0,0,0
39,1,0,0,0,0,0,0,0,0,0,0,0,0,0,0,0
40,0,0,0,0,0,0,0,0,1,1,0,0,0,0,1,0
41,0,0,0,0,0,0,0,0,0,0,0,0,0,0,1,0
42,0,0,0,0,0,0,0,0,0,0,0,0,1,0,0,0
43,0,0,1,0,0,0,0,0,0,0,0,0,0,0,0,0
44,0,0,0,0,1,0,0,0,0,0,0,0,0,0,0,0
45,0,0,1,0,0,0,0,0,0,0,0,0,0,0,0,0
46,1,0,0,0,0,0,0,0,0,0,0,0,0,0,0,0
47,0,0,0,0,0,0,0,0,0,0,0,1,0,0,0,1
48,0,0,0,0,0,0,1,0,0,0,0,0,0,0,0,0
49,0,0,0,0,0,0,0,0,0,0,0,0,0,0,1,0
50,1,0,0,0,0,1,0,0,0,0,0,0,0,0,0,0
51,0,0,1,0,0,0,0,0,0,0,0,0,0,0,0,0
52,0,0,1,0,0,0,0,0,0,0,0,0,0,0,0,0
53,0,0,0,0,0,0,0,0,0,0,0,0,1,0,0,0
54,1,0,0,0,0,0,0,0,0,0,0,0,0,0,0,0
55,0,0,0,1,0,0,0,0,0,0,0,0,0,0,0,0
56,0,1,0,0,0,0,0,0,0,0,0,0,0,0,0,0
57,0,0,0,0,0,0,1,0,1,1,0,0,1,0,0,0
58,0,0,0,0,0,0,0,0,0,0,1,0,0,0,0,0
59,0,0,0,0,0,0,1,0,0,1,1,0,0,0,0,0
60,1,0,0,0,0,0,0,0,0,0,0,0,0,0,0,0
61,0,1,0,0,0,1,0,0,0,0,0,0,0,0,0,0
62,0,0,0,0,0,0,0,0,1,1,0,0,0,0,1,0
63,0,0,1,0,0,0,0,0,0,0,0,0,0,0,0,0
64,0,0,0,0,1,0,0,0,0,0,0,0,0,0,0,0
65,0,0,0,0,1,0,0,0,0,0,0,0,0,0,0,0
66,0,0,0,0,0,0,0,0,0,0,1,0,0,0,0,0
67,0,0,0,0,0,0,0,0,0,0,0,0,0,0,0,1
68,0,0,0,0,0,0,0,0,0,0,0,0,1,0,0,0
69,0,0,0,0,0,1,0,0,0,0,0,0,0,0,0,0
70,0,0,0,1,0,0,0,0,0,0,0,0,0,0,0,0
71,0,0,0,1,0,0,0,0,0,0,1,0,0,0,0,0
72,1,0,0,0,0,0,0,0,0,0,0,0,0,0,0,0
73,0,0,0,0,0,0,0,1,0,0,0,0,0,0,0,0
74,0,0,0,0,0,0,0,0,0,0,0,0,0,0,1,0
75,1,0,0,0,0,0,0,0,0,0,0,0,0,0,0,0
76,0,0,0,0,0,0,0,0,0,0,0,0,1,0,0,0
77,0,0,0,0,0,0,0,0,0,0,0,1,0,0,0,0
78,0,0,0,0,0,0,1,0,0,0,0,0,0,0,0,0
79,0,0,0,0,0,0,0,0,0,0,1,0,0,0,0,0
80,1,0,0,0,0,0,0,0,0,0,0,0,0,0,0,0
81,0,0,0,0,0,0,0,1,0,0,0,0,0,0,0,0
82,0,0,0,1,0,0,0,0,0,0,0,0,0,0,0,0
83,0,0,0,0,0,0,0,0,0,0,0,0,1,0,0,0
84,0,0,0,0,0,0,0,0,0,0,0,1,0,0,0,0
85,0,0,0,0,0,1,0,0,0,0,0,0,0,0,0,0
86,0,0,0,0,0,0,0,0,0,0,0,1,0,0,0,0
87,0,0,0,0,0,0,0,0,0,0,0,0,0,0,1,0
88,0,1,0,0,0,0,0,0,0,0,0,0,0,0,0,0
89,0,0,1,0,0,0,0,0,0,0,0,0,0,0,0,0
90,0,0,0,0,0,1,0,0,0,0,0,0,0,0,0,0
91,0,0,0,0,0,0,0,0,0,0,0,1,0,0,0,0
92,0,0,0,0,0,1,0,0,0,0,0,0,0,0,0,0
93,0,1,0,0,0,0,0,0,0,0,0,0,0,0,0,0
94,0,0,0,0,0,0,0,1,0,0,0,0,0,0,0,0
95,0,0,1,0,0,0,0,0,0,0,0,0,0,0,0,0
96,1,0,0,0,0,0,0,0,0,0,0,0,0,0,0,0
97,0,0,0,0,0,0,1,0,0,0,0,0,0,0,0,0
98,0,0,0,1,0,0,0,0,0,0,0,0,0,0,0,0
99,1,0,0,0,0,0,0,0,0,0,0,0,0,0,0,0
100,0,1,0,0,0,0,0,0,0,0,0,0,0,0,0,0
101,0,0,0,0,0,1,0,0,0,0,0,0,0,0,0,0
102,0,1,0,0,0,0,0,0,0,0,0,0,0,0,0,0
103,0,0,0,0,0,0,0,0,0,0,0,0,0,1,0,0
104,0,0,0,0,0,0,0,0,1,0,0,0,0,0,0,0
105,0,0,0,0,0,0,0,0,1,1,0,0,0,0,1,0
106,0,1,0,0,0,0,0,0,0,0,0,0,0,0,0,0
107,0,0,0,0,0,0,0,0,0,0,0,0,0,0,1,0
108,0,0,0,0,0,0,0,0,0,0,0,1,0,0,0,0
109,0,0,0,0,0,0,0,0,0,0,0,1,0,0,1,1
110,0,0,0,0,0,0,1,0,0,0,0,0,0,0,0,0
111,0,0,0,0,0,0,1,0,0,0,0,0,0,0,0,0
112,0,0,0,0,0,0,0,0,0,0,1,0,0,0,0,1
113,0,0,0,0,0,0,1,0,0,1,0,0,0,1,0,0
114,1,0,0,0,0,0,0,0,0,0,0,0,0,0,0,0
115,1,0,0,0,0,0,0,0,0,0,0,0,0,0,0,0
116,0,0,0,0,0,0,0,1,0,0,0,0,0,0,0,0
117,0,0,0,0,0,0,0,1,0,0,0,0,0,0,0,0
118,0,0,0,0,0,0,0,0,0,0,1,0,0,0,0,0
119,0,0,0,0,0,0,0,0,0,0,0,0,0,0,0,1
120,1,0,0,0,0,0,0,0,0,0,0,0,0,0,0,0
121,0,0,1,0,0,0,0,0,0,0,0,0,0,0,0,0
122,1,0,0,0,1,0,0,0,0,0,0,0,0,0,0,0
123,0,0,0,0,0,0,0,0,0,0,0,0,0,0,1,1
124,0,0,1,0,0,0,0,0,0,0,0,0,0,0,0,0
125,0,0,0,0,0,0,0,0,0,0,0,0,0,0,0,1
126,0,1,0,0,0,0,0,0,0,0,0,0,0,0,0,0
127,0,0,0,0,0,0,0,0,0,0,0,0,0,0,1,0
128,1,0,0,0,0,0,0,0,0,0,0,0,0,0,0,0
129,0,1,0,0,0,0,0,0,0,0,0,0,0,0,0,0
130,0,0,0,1,0,0,0,0,0,0,0,0,0,0,0,0
131,0,1,0,0,0,0,0,0,0,0,0,0,0,0,0,0
132,0,0,0,0,0,0,0,0,0,0,0,0,0,0,0,1
133,0,1,0,1,0,0,0,0,0,0,0,0,0,0,0,0
134,0,0,0,1,0,0,0,0,0,0,0,0,0,0,0,0
135,1,1,0,1,0,0,0,0,0,0,0,0,0,0,0,0
136,0,0,0,0,0,0,0,0,0,0,0,0,0,1,0,0
137,1,0,0,0,0,0,0,0,0,0,0,0,0,0,0,0
138,0,0,0,0,0,0,0,0,0,0,0,0,0,0,1,0
139,1,0,0,0,0,0,0,0,0,0,0,0,0,0,0,0
140,0,0,0,0,0,0,0,0,1,1,0,0,0,0,1,0
141,0,0,0,0,0,0,0,0,1,0,0,0,0,0,0,0
142,0,0,0,0,0,0,0,0,0,0,1,0,0,0,0,0
143,0,0,0,0,0,0,0,0,0,0,0,0,0,0,0,1
144,0,0,0,0,0,0,0,0,0,0,0,0,0,0,0,1
145,0,0,0,0,0,0,1,0,0,1,0,0,1,0,0,0
146,1,0,0,0,0,0,0,0,0,0,0,0,0,0,0,0
147,1,0,0,0,0,0,0,0,0,0,0,0,0,0,0,0
148,1,0,0,0,0,0,0,0,0,0,0,0,0,0,0,0
149,0,0,0,0,0,0,0,0,0,0,0,0,1,0,0,0
150,0,0,0,0,0,0,0,0,1,0,0,0,0,0,0,0
151,0,0,0,0,0,0,0,0,1,0,0,0,0,0,0,0
152,0,0,0,0,0,0,0,0,1,1,1,0,1,0,0,0
153,0,0,0,0,0,0,0,0,1,1,0,0,0,0,1,0
154,0,0,0,0,0,0,0,0,0,0,0,1,0,0,0,0
155,0,0,0,1,0,0,0,0,0,0,0,0,0,0,0,0
156,0,0,1,0,0,0,0,0,0,0,0,0,0,0,0,0
157,0,0,0,0,0,0,0,0,0,0,1,0,0,0,1,0
158,0,0,0,0,0,0,0,0,0,0,1,0,0,0,0,1
159,0,0,0,0,0,0,0,0,0,0,0,0,1,0,0,0
160,1,0,0,0,0,0,0,0,0,0,0,0,0,0,0,0
161,0,0,0,0,0,0,0,0,0,0,0,0,0,0,0,1
162,1,0,0,0,0,0,0,0,0,0,0,0,0,0,0,0
163,0,0,0,0,0,0,1,0,0,0,0,0,0,0,0,0
164,0,0,0,0,0,0,0,0,1,1,0,0,1,0,0,0
165,0,1,0,0,0,0,0,0,0,0,0,0,0,0,0,0
166,0,0,0,0,0,0,0,0,0,0,0,0,0,0,1,0
167,0,0,0,0,0,0,1,1,0,0,0,0,0,0,0,0
168,0,0,0,0,1,0,0,0,0,0,0,0,0,0,0,0
169,0,0,0,1,0,0,0,0,0,0,0,0,0,0,0,0
170,0,0,0,0,0,0,0,0,0,0,1,0,0,0,0,0
171,0,0,0,0,0,0,0,0,0,0,1,0,0,0,0,0
172,1,0,0,0,0,0,0,0,0,0,0,0,0,0,0,0
173,0,0,0,0,0,0,0,0,1,1,0,0,0,0,1,0
174,0,0,0,0,0,0,0,0,0,0,1,0,0,0,0,0
175,0,0,0,0,0,0,0,0,0,1,1,0,0,0,0,0
176,0,0,1,0,0,0,0,0,0,0,0,0,0,0,0,0
177,0,0,1,0,0,0,0,0,0,0,0,0,0,0,0,0
178,0,0,0,0,0,0,0,0,0,0,0,0,0,0,0,1
179,0,1,0,0,0,0,0,0,0,0,0,0,0,0,0,0
180,0,0,0,0,0,0,1,0,0,0,0,0,0,0,0,0
181,0,0,0,0,0,0,0,0,0,0,0,0,0,0,0,1
182,0,0,1,0,0,0,0,0,0,0,0,0,0,0,0,0
183,0,0,0,0,0,0,0,0,0,0,0,0,0,0,1,0
184,0,0,0,0,0,0,0,0,0,0,0,0,0,0,1,0
185,1,0,0,0,0,0,0,0,0,0,0,0,0,0,0,0
186,0,0,0,0,0,0,1,0,0,0,0,0,0,0,0,0
187,0,0,0,0,0,0,1,0,0,0,0,0,0,0,0,0
188,0,0,0,0,1,0,0,0,0,0,0,0,0,0,0,0
189,0,0,0,0,0,0,0,0,0,0,0,0,1,0,0,0
190,0,0,0,0,0,0,1,0,0,0,0,0,0,0,0,0
191,0,0,0,0,0,0,1,0,0,1,0,0,1,0,0,0
192,0,0,0,0,0,0,0,0,0,0,0,0,0,1,0,0
193,0,0,0,0,0,0,0,0,0,0,0,0,0,0,0,1
194,0,0,0,0,0,0,1,0,0,0,0,0,0,0,0,0
195,0,0,0,0,1,0,0,0,0,0,0,0,0,0,0,0
196,0,0,0,0,0,1,0,0,0,0,0,0,0,0,0,0
197,0,0,0,0,0,0,0,0,0,0,0,0,0,0,1,0
198,1,0,0,0,0,0,0,0,0,0,0,0,0,0,0,0
199,0,0,0,0,0,0,0,0,0,0,0,0,0,1,0,0
200,0,0,0,0,0,0,0,0,0,0,0,1,0,0,0,0
201,0,0,0,0,0,0,0,0,0,0,0,0,0,0,1,0
202,0,0,0,0,0,1,0,0,0,0,0,0,0,0,0,0
203,0,0,1,0,0,0,0,0,0,0,0,0,0,0,0,0
204,0,0,0,0,0,0,1,0,0,0,0,0,0,0,0,0
205,0,0,0,0,0,0,1,0,0,0,0,0,0,0,0,0
206,0,0,0,0,0,0,0,0,0,0,0,0,0,1,0,0
207,0,0,0,0,0,0,0,0,0,0,1,0,0,0,0,0
208,0,1,1,0,0,0,0,0,0,0,0,0,0,0,0,0
209,0,0,0,0,0,0,0,0,0,0,0,0,1,0,0,0
210,0,0,0,0,0,1,0,0,0,0,0,0,0,0,0,0
211,0,0,0,0,0,1,0,0,0,0,0,0,0,0,0,0
212,0,0,0,0,0,1,0,0,0,0,0,0,0,0,0,0
213,0,0,0,0,0,0,0,0,0,0,0,1,0,0,0,0
214,0,0,0,0,0,0,0,0,0,0,0,1,0,0,0,0
215,0,0,1,0,0,0,0,0,0,0,0,0,0,0,0,0
216,0,0,0,0,0,0,0,0,0,0,1,0,0,0,0,0
217,0,1,0,0,0,0,0,0,0,0,0,0,0,0,0,0
218,0,0,0,0,0,0,0,0,0,0,1,0,0,0,0,0
219,0,0,0,0,1,0,0,0,0,0,0,0,0,0,0,0
220,0,0,0,0,0,0,0,0,0,0,0,0,0,0,1,0
221,0,0,0,0,0,0,0,0,0,0,0,0,0,0,1,0
222,1,0,0,0,0,0,0,0,0,0,0,0,0,0,0,0
223,0,0,0,0,0,0,0,0,0,0,0,0,0,0,0,1
224,0,0,0,0,0,0,1,0,1,0,0,0,0,0,0,0
225,0,0,0,0,1,0,0,0,0,0,0,0,0,0,0,0
226,0,0,0,0,0,0,0,0,0,0,0,1,0,0,0,0
227,0,0,0,0,0,0,0,0,0,0,0,1,0,0,0,1
228,0,1,0,0,0,0,0,0,0,0,0,0,0,0,0,0
229,0,0,0,0,0,0,0,0,0,0,0,1,0,0,0,0
230,0,0,0,0,0,0,0,0,0,0,0,1,0,0,0,0
231,0,0,0,0,0,0,0,0,0,0,0,0,0,0,0,1
232,0,0,0,0,0,0,0,1,0,0,0,0,0,0,0,0
233,0,0,0,0,0,0,0,0,0,1,1,0,0,0,0,0
234,0,0,0,0,0,0,1,1,0,0,0,0,0,0,0,0
235,0,0,0,0,0,1,0,0,0,0,0,0,0,0,0,0
236,0,0,0,0,0,1,0,0,0,0,0,0,0,0,0,0
237,0,0,0,0,0,0,0,0,0,0,0,1,0,0,0,0
238,0,0,0,0,0,1,0,0,0,0,0,0,0,0,0,0
239,0,0,0,0,0,1,0,0,0,0,0,0,0,0,0,0
240,0,0,1,0,0,0,0,0,0,0,0,0,0,0,0,0
241,0,0,1,0,0,0,0,0,0,0,0,0,0,0,0,0
242,0,0,0,0,0,0,0,0,0,0,0,1,0,0,0,0
243,0,0,0,0,0,0,1,0,0,0,0,0,0,0,0,0
244,0,1,0,0,0,0,0,0,0,0,0,0,0,0,0,0
245,0,0,0,0,0,0,0,0,0,0,0,0,0,0,0,1
246,0,1,0,0,0,0,0,0,0,0,0,0,0,0,0,0
247,0,0,0,0,0,0,0,0,0,0,0,0,0,1,0,0
248,0,1,0,0,0,0,0,0,0,0,0,0,0,0,0,0
249,0,0,0,0,0,0,0,0,1,0,0,0,0,0,0,0
250,0,0,0,0,0,1,0,0,0,0,0,0,0,0,0,0
251,0,0,0,0,0,0,0,0,0,0,0,1,0,0,0,0
252,0,0,0,0,0,0,0,0,0,0,0,1,0,0,0,0
253,0,0,1,0,0,0,0,0,0,0,0,0,0,0,0,0
254,0,0,0,0,0,0,0,0,1,1,0,0,1,0,0,0
255,0,1,0,0,0,0,0,0,0,0,0,0,0,0,0,0
256,0,0,0,0,0,0,0,0,0,0,1,0,0,0,0,1
257,0,0,0,0,0,0,0,0,0,0,1,0,0,0,0,0
258,0,0,0,0,0,0,0,0,1,0,0,0,0,0,0,0
259,0,0,0,0,0,0,0,0,0,0,0,0,0,0,1,0
260,0,0,0,0,0,0,0,0,0,0,0,0,1,0,0,0
261,1,0,0,0,0,0,0,0,0,0,0,0,0,0,0,0
262,1,0,0,0,0,0,0,0,0,0,0,0,0,0,0,0
263,0,0,0,0,0,0,0,0,0,0,0,0,0,0,0,1
264,0,1,0,0,0,0,0,0,0,0,0,0,0,0,0,0
265,0,0,0,0,0,0,0,0,1,1,0,0,1,0,0,0
266,0,0,0,0,0,0,0,0,0,0,1,0,0,0,0,0
267,1,0,0,0,0,0,0,0,0,0,0,0,0,0,0,0
268,0,0,0,0,0,0,0,0,1,1,0,0,1,0,0,0
269,0,0,1,0,0,0,0,0,0,0,0,0,0,0,0,0
270,0,0,0,0,0,0,0,0,0,0,0,1,0,0,0,1
271,0,0,0,0,0,0,1,0,0,0,0,0,0,0,0,0
272,0,0,0,0,0,0,0,0,0,0,0,0,1,0,0,1
273,0,0,0,0,0,0,0,0,0,0,0,0,1,0,0,0
274,1,0,0,0,0,0,0,0,0,0,0,0,0,0,0,0
275,0,0,0,0,0,0,0,0,0,0,0,0,1,0,0,0
276,0,0,0,0,0,0,0,0,0,0,0,0,1,0,0,0
277,0,0,0,0,0,0,1,0,0,1,0,0,0,0,0,0
278,0,0,0,0,0,0,0,0,0,0,1,0,0,0,0,0
279,0,0,0,0,0,0,0,0,1,0,0,0,0,0,0,0
280,0,1,0,0,0,0,0,0,0,0,0,0,0,0,0,0
281,0,0,1,0,0,0,0,0,0,0,0,0,0,0,0,0
282,1,1,0,0,0,0,0,0,0,0,0,0,0,0,0,0
283,0,0,0,0,0,0,0,0,0,0,0,0,0,0,1,1
284,1,0,0,0,0,0,0,0,0,0,0,0,0,0,0,0
285,1,0,1,0,0,0,0,0,0,0,0,0,0,0,0,0
286,0,0,0,0,0,0,0,0,0,0,0,0,0,0,0,1
287,0,0,0,0,0,0,0,0,1,1,0,0,0,0,1,0
288,0,0,0,0,0,0,1,0,0,0,0,0,0,0,0,0
289,0,0,0,0,0,0,0,1,0,0,0,0,0,0,0,0
290,0,0,0,0,0,0,0,0,0,0,0,0,0,0,1,0
291,0,0,0,0,0,0,0,0,0,1,0,0,1,0,0,0
292,0,0,0,0,0,0,0,0,0,1,0,1,0,0,0,0
293,0,0,0,0,0,0,0,0,0,0,1,0,0,0,0,0
294,0,0,0,0,0,0,0,0,0,0,0,0,1,0,0,0
295,0,0,0,0,1,0,0,0,0,0,0,0,0,0,0,0
296,0,0,0,0,0,0,0,0,0,0,0,0,0,0,0,1
297,0,0,0,0,0,1,0,0,0,0,0,0,0,0,0,0
298,0,1,0,0,0,0,0,0,0,0,0,0,0,0,0,0
299,0,0,0,0,0,0,0,0,0,0,0,0,0,0,1,0
300,1,0,0,0,0,0,0,0,0,0,0,0,0,0,0,0
301,0,0,0,0,0,0,0,0,0,0,0,0,0,0,0,1
302,1,0,0,0,0,0,0,0,0,0,0,0,0,0,0,0
303,0,0,1,0,0,0,0,0,0,0,0,0,0,0,0,0
304,0,0,0,0,0,0,0,0,0,0,0,0,0,0,1,0
305,0,0,0,0,0,0,1,0,0,1,0,0,1,0,0,0
306,0,0,0,0,0,0,0,1,0,0,0,0,0,0,0,0
307,0,0,0,0,0,0,0,0,0,0,0,0,0,0,0,1
308,0,0,0,0,0,0,0,0,0,0,0,0,0,0,0,1
309,0,0,0,0,0,0,1,0,0,0,0,0,0,0,0,0
310,0,0,0,0,0,0,0,0,0,0,0,0,1,0,0,0
311,0,1,1,0,0,0,0,0,0,0,0,0,0,0,0,0
312,0,0,0,0,0,0,0,0,0,0,0,0,1,0,0,0
313,0,0,0,0,0,0,0,0,0,0,0,0,1,0,0,0
314,0,0,0,0,0,0,0,0,0,0,0,0,1,0,0,0
315,0,0,0,0,0,1,0,0,0,0,0,0,0,0,0,0
316,0,0,0,0,0,0,0,0,0,0,0,0,1,0,0,0
317,0,1,1,0,0,0,0,0,0,0,0,0,0,0,0,0
318,0,1,0,0,0,0,0,0,0,0,0,0,0,0,0,0
319,0,0,0,0,0,0,0,0,0,0,0,0,0,0,0,1
320,0,0,0,1,0,0,0,0,0,0,0,0,0,0,0,0
321,1,0,0,0,0,0,0,0,0,0,0,0,0,0,0,0
322,1,0,0,0,0,0,0,0,0,0,0,0,0,0,0,0
323,0,0,0,0,0,0,1,0,1,0,0,0,0,0,0,0
324,0,0,0,0,0,0,1,0,0,0,0,0,0,0,0,0
325,0,0,0,0,1,0,0,0,0,0,0,0,0,0,0,0
326,0,0,0,0,0,0,0,0,0,0,0,0,1,0,0,0
327,0,0,0,0,0,0,0,0,0,0,0,1,0,0,0,0
328,0,0,1,0,0,0,0,0,0,0,0,0,0,0,0,0
329,0,0,0,0,0,1,0,0,0,0,0,0,0,0,0,0
330,0,0,0,0,0,0,0,0,0,0,0,1,0,0,0,0
331,0,0,0,0,0,1,0,0,0,0,0,0,0,0,0,0
332,1,1,0,0,0,1,0,0,0,0,0,0,0,0,0,1
333,0,0,0,0,0,0,0,0,1,1,0,0,0,0,1,0
334,0,0,0,0,0,0,0,0,0,0,0,1,0,0,0,0
335,1,0,0,0,0,0,0,0,0,0,0,0,0,0,0,0
336,0,0,0,1,0,0,0,0,0,0,0,0,0,0,0,0
337,0,0,0,1,0,0,0,0,0,0,0,0,0,0,0,0
338,0,0,0,0,0,0,0,0,1,0,0,0,0,0,0,0
339,0,0,0,0,0,0,0,0,1,1,0,0,1,0,1,0
340,0,0,0,0,0,0,0,0,0,1,0,0,0,1,0,0
341,0,0,0,0,0,0,0,1,0,0,0,0,0,0,0,0
342,0,0,0,0,0,0,1,0,0,0,0,0,0,0,0,0
343,0,0,1,0,0,0,0,0,0,0,0,0,0,0,0,0
344,0,0,0,0,0,0,0,1,0,0,0,0,0,0,0,0
345,0,0,0,0,0,0,0,0,1,1,0,0,0,0,1,0
346,0,1,0,0,0,0,0,0,0,0,0,0,0,0,0,0
347,0,0,0,0,0,0,0,0,0,1,0,1,0,0,0,0
348,0,0,0,0,0,0,0,0,0,0,0,0,0,0,0,1
349,0,0,0,0,0,0,0,0,1,1,0,0,0,0,1,0
350,0,0,0,0,0,0,0,1,0,0,0,0,0,0,0,0
351,0,0,0,0,0,0,0,0,0,0,0,0,1,0,0,0
352,0,1,0,0,0,0,0,0,0,0,0,0,0,0,0,0
353,0,0,0,0,0,0,0,0,0,0,0,0,1,0,0,0
354,0,0,0,0,0,0,0,0,0,0,0,0,0,1,0,0
355,0,0,0,0,0,0,1,0,0,0,0,0,0,0,0,0
356,0,0,0,0,0,0,1,0,0,0,0,0,0,0,0,0
357,0,0,0,0,0,0,1,0,0,0,0,0,0,0,0,0
358,0,0,1,0,0,0,0,0,0,0,0,0,0,0,0,0
359,0,0,0,0,0,0,0,0,1,0,0,0,0,0,0,0
360,0,0,0,0,0,0,0,0,1,1,0,0,0,1,0,0
361,0,0,0,0,0,0,0,0,0,0,0,1,0,1,0,1
362,0,0,0,0,0,0,0,0,1,1,0,0,0,0,1,0
363,0,0,1,0,0,0,0,0,0,0,0,0,0,0,0,0
364,0,0,0,0,0,0,0,0,0,0,0,0,0,0,1,0